                                
##########################
####   ######   ##########
###### ######## ##########
###### ######## ##########
###### ######## ##########
###### ####$### ##########
###### ######## ##########
###### ######## ##########
###### ######## ##########
####     ####     ########
##########################
                               
